11111111111111111111
1P0000000000000000E1
10000000000000000001
10001000000000001001
10001000000000001001
10000000000000000001
10000000000000000001
10000000000000000001
10000000000000000001
10001000000000001001
10001000000000001001
10001000000000001001
10000000000000000001
10000000000000000001
10000000000000000001
10001000000000001001
10001000000000001001
1C0000000000000000C1
10000000000000000001
11111111111111111111