111111111111111111111111111111111111111
100000000000000000000000000000000000P01
100000000001111111001111111111111000C01
100000000011111100001111100111111000C01
100000001111111000001110001111110000E01
100001111100000000000000011111100000001
100011111000000000000001111110000000001
101111110000000000000111111000000000001
111111111111111111111111111110011000001
111111111111111111111111111011110000001
100000000000011111101111111111110000001
100000000000011111100000000000000000001
100000000000011111100000000000000000001
100000000000000000000000000000000000001
111111111111111111111111111111111111111