1111111111
1P000000C1
1001111001
1000011001
1C00000E1
1111111111