1111111111
1P00000001
1001111001
1000011001
10000000E1
1111111111