11111111111111111111
1P0000000000000000E1
11101111111111111011
10001000000000001001
10111110111111101011
101000001000Y0101001
10101111101011101011
1C0010000000001000C1
11111111111111111111