11111111111111111111
100000000000000001E1
10000000000000000011
10001011110C00001001
1P001000000000001001
10000000000C00000001
10000000000000000001
10000010000000000001
10000C10000100000001
10001000000000001001
10001000000000001001
10001000000000001001
10000111111111110001
10000000000000000001
10000000000000000001
10001000000C00001001
10001000000000001001
1C0000000000000111C1
10000000000000010001
11111111111111111111